.........#..........
.........#..........
.........#..........
...$.....#..........
.........#..........
.........#..........
.........#..........
.........#..........
.........#..........
####################
.........#..........
.........#..........
.........#..........
.........#..........
.........#..........
.........#..........
.........#..........
.........#..........
.........#..........
.........#..........