....................#
...##############...#
...#............#...#
...#............#...#
...#............#...#
...#............#...#
...#............#...#
...#........#####...#
...#................#
...##############...#
............$...#...#
...#####........#...#
...#............#...#
...#............#...#
...#............#...#
...#............#...#
...#............#...#
...#............#...#
...##############...#
....................#
#####################